/dev/serial/by-id/usb-Teensyduino_USB_Serial_12345-if00

XV Lidar Controller Firmware Version 1.4.0
GetSurreal.com * 
 
List of available commands
 
Control commands
  ShowConfig    - Show the running configuration
  SaveConfig    - Save the running configuration to EEPROM
  ResetConfig   - Restore the original configuration
  SetAngle      - Show distance data for a multiple angles (Ex: SetAngle 0, 15-30, 45-50, 10)
  SetRPM        - Set the desired rotation speed (min: 180, max: 349)
  MotorOff      - Stop spinning the lidar
  MotorOn       - Enable spinning of the lidar
 
Data commands
  ShowRaw       - Enable the output of the raw lidar data (default)
  HideRaw       - Stop outputting the raw data from the lidar
  ShowDist      - Show angles with distance data
  HideDist      - Hide the distance data
  ShowErrors    - Show all error types (CRC, Signal Strength, and Invalid
  HideErrors    - Hide angles with errors
  ShowRPM       - Show the rotation speed
  HideRPM       - Hide the rotation speed
  ShowInterval  - Show time interval per revolution in ms, at angle=0
  HideInterval  - Hide time interval
  ShowAll       - Show the distance, errors, RPMs and interval data
  HideAll       - Hide the distance, errors, RPMs and interval data
 
PID commands
  SetKp         - Set the proportional gain
  SetKi         - Set the integral gain
  SetKd         - Set the derivative gain
  SetSampleTime - Set the frequency the PID is calculated (ms)
 
Output comma-separated format:
  A,<Angle>,<Distance in mm>,<Strength>
  C,CRC error was generated by LIDAR
  R,<RPMs>,<PWM value>
  T,<Time interval in milliseconds>
 
Errors:
  CRC = CRC Error
    I = LIDAR reports Invalid data for this angle
    S = LIDAR reports Poor signal strength for this angle
